%%%%%%%%%
%.......%
%.%%%%%.%
%.%%%%%.%
%.%%%%%.%
%P......%
%%%%%%%%%
