%%%%%%
% P  %
% %% %
% %. %
% %% %
%. G %
%%%%%%
